Regulator	Regulator_class
A1BG	EM_downstream
AADAC	UC_downstream
ABCB1	EM_downstream
ABCB6	EM_downstream
ABCC1	UC_downstream
ABCC2	UC_downstream
ABL1	Mixed_downstream
ACO1	MM_downstream
ACTA2	Mixed_downstream
ACTL6A	Mixed_downstream
ADAM17	EM_downstream
ADAR	UC_downstream
ADCY7	EM_downstream
ADIPOQ	None
ADIPOR1	UC_downstream
ADIRF	EM_downstream
ADM	UC_downstream
ADORA2A	UC_downstream
ADORA2B	UC_downstream
ADRA2A	EM_downstream
ADRA2B	EM_downstream
ADRA2C	EM_downstream
ADRB1	UC_downstream
ADRB2	Mixed_downstream
AES	Mixed_downstream
AGAP2	EM_downstream
AGO1	None
AGO2	UC_downstream
AGO3	None
AGO4	None
AGT	EM_downstream
AGTR1	EM_downstream
AGTR2	UC_downstream
AHR	Mixed_downstream
AHRR	UC_downstream
AIM2	EM_downstream
AKAP13	EM_downstream
AKR1B10	EM_downstream
AKR1B1	Mixed_downstream
AKT1	EM_downstream
AKT2	EM_downstream
ALDH1A1	Mixed_downstream
ALDH2	None
ALK	EM_downstream
ALOX15	Mixed_downstream
ALX1	Mixed_downstream
ALX4	None
AMH	EM_downstream
AMN	EM_downstream
ANAPC10	EM_downstream
ANAPC11	EM_downstream
ANAPC15	EM_downstream
ANAPC16	EM_downstream
ANAPC1	EM_downstream
ANAPC2	EM_downstream
ANAPC4	EM_downstream
ANAPC5	EM_downstream
ANAPC7	EM_downstream
ANGPT1	None
ANGPT2	None
ANGPT4	EM_downstream
ANXA1	EM_downstream
AP1S1	Mixed_downstream
APOA1	EM_downstream
APP	None
APPL1	EM_downstream
AR	Mixed_downstream
ARAF	EM_downstream
AREG	UC_downstream
ARHGEF17	UC_downstream
ARHGEF2	MM_downstream
ARL6IP5	EM_downstream
ARNT2	UC_downstream
ARNT	Mixed_downstream
ARNTL2	EM_downstream
ARNTL	Mixed_downstream
ARRB1	EM_downstream
ARRB2	Mixed_downstream
ARTN	EM_downstream
ASAH2	EM_downstream
ASCL1	None
ASH2L	EM_downstream
ATF1	Mixed_downstream
ATF2	Mixed_downstream
ATF3	Mixed_downstream
ATF4	Mixed_downstream
ATF5	EM_downstream
ATF6	Mixed_downstream
ATF7	EM_downstream
ATG5	None
ATG7	Mixed_downstream
ATM	None
ATP1B4	EM_downstream
ATP2A1	UC_downstream
ATP7B	Mixed_downstream
ATR	UC_downstream
BACH1	Mixed_downstream
BACH2	Mixed_downstream
BATF3	MM_downstream
BCAR1	EM_downstream
BCL2	EM_downstream
BCL2L1	Mixed_downstream
BCL3	EM_downstream
BCL6	EM_downstream
BCL9	EM_downstream
BCR	EM_downstream
BDNF	Mixed_downstream
BECN1	None
BHLHE40	UC_downstream
BHLHE41	EM_downstream
BID	None
BIN1	UC_downstream
BIRC5	EM_downstream
BLVRA	Mixed_downstream
BMF	EM_downstream
BMP2	EM_downstream
BMP4	EM_downstream
BMP6	EM_downstream
BMP7	EM_downstream
BMPR2	EM_downstream
BNIP3L	Mixed_downstream
BPTF	Mixed_downstream
BRAF	EM_downstream
BRCA1	Mixed_downstream
BRD4	EM_downstream
BSG	EM_downstream
C5	EM_downstream
CA9	Mixed_downstream
CALCA	Mixed_downstream
CALCOCO1	MM_downstream
CALM1	Mixed_downstream
CALM2	Mixed_downstream
CALM3	Mixed_downstream
CAMP	UC_downstream
CARM1	Mixed_downstream
CASP1	EM_downstream
CASP3	None
CASP8	EM_downstream
CASR	None
CAT	Mixed_downstream
CAV1	Mixed_downstream
CAV3	Mixed_downstream
CBFA2T3	Mixed_downstream
CBFB	None
CBL	EM_downstream
CBR1	Mixed_downstream
CCDC59	MM_downstream
CCKBR	EM_downstream
CCL11	EM_downstream
CCL2	MM_downstream
CCL5	EM_downstream
CCNC	None
CCND1	EM_downstream
CCND3	EM_downstream
CCNH	UC_downstream
CCNT1	UC_downstream
CCNT2	UC_downstream
CCS	EM_downstream
CD28	EM_downstream
CD2	MM_downstream
CD3D	EM_downstream
CD3E	EM_downstream
CD3G	EM_downstream
CD40LG	EM_downstream
CD44	Mixed_downstream
CD4	EM_downstream
CD55	EM_downstream
CD80	EM_downstream
CD86	EM_downstream
CD8A	EM_downstream
CDC16	EM_downstream
CDC23	EM_downstream
CDC25C	EM_downstream
CDC26	EM_downstream
CDC42	None
CDC5L	EM_downstream
CDH1	EM_downstream
CDH2	EM_downstream
CDK12	UC_downstream
CDK19	None
CDK4	EM_downstream
CDK6	EM_downstream
CDK7	UC_downstream
CDK8	None
CDK9	UC_downstream
CDKN1A	EM_downstream
CDKN1B	Mixed_downstream
CDKN2A	Mixed_downstream
CDKN2D	EM_downstream
CDX2	Mixed_downstream
CEBPB	Mixed_downstream
CEBPD	Mixed_downstream
CEBPG	Mixed_downstream
CEBPZ	UC_downstream
CES1	Mixed_downstream
CES2	EM_downstream
CFD	EM_downstream
CFTR	Mixed_downstream
CGA	EM_downstream
CGB8	EM_downstream
CHEK1	UC_downstream
CHEK2	None
CHRNA3	EM_downstream
CHRNA5	EM_downstream
CHRNA7	Mixed_downstream
CHRNB2	UC_downstream
CHUK	Mixed_downstream
CIITA	EM_downstream
CITED2	EM_downstream
CLDN3	UC_downstream
CLDN4	UC_downstream
CLEC4E	EM_downstream
CLOCK	Mixed_downstream
CLPTM1L	EM_downstream
CLU	EM_downstream
CMA1	Mixed_downstream
CMTM2	EM_downstream
CNR1	UC_downstream
CNR2	EM_downstream
CNTF	Mixed_downstream
COL18A1	EM_downstream
COMMD1	EM_downstream
COMT	Mixed_downstream
COPS5	EM_downstream
CP	UC_downstream
CRABP2	EM_downstream
CREB1	Mixed_downstream
CREB3L1	EM_downstream
CREB3L3	EM_downstream
CREBBP	Mixed_downstream
CREM	None
CRH	EM_downstream
CRHR2	EM_downstream
CRP	EM_downstream
CRTC1	EM_downstream
CRTC2	EM_downstream
CRTC3	EM_downstream
CRX	EM_downstream
CRY1	EM_downstream
CRY2	EM_downstream
CSE1L	Mixed_downstream
CSF1	EM_downstream
CSF2	EM_downstream
CSF3	None
CSK	Mixed_downstream
CTBP1	EM_downstream
CTCF	UC_downstream
CTDP1	UC_downstream
CTDSP1	EM_downstream
CTGF	EM_downstream
CTNNB1	EM_downstream
CTNND1	EM_downstream
CUX1	Mixed_downstream
CXCL12	EM_downstream
CXCL1	EM_downstream
CXCR3	EM_downstream
CXCR4	EM_downstream
CYBA	None
CYBB	UC_downstream
CYLD	EM_downstream
CYP1A1	Mixed_downstream
CYP1A2	EM_downstream
CYP1B1	EM_downstream
CYP26A1	EM_downstream
CYP27B1	Mixed_downstream
CYP2A13	UC_downstream
CYP2C9	EM_downstream
CYP2D6	EM_downstream
CYP2E1	None
CYP3A4	None
CYP4Z1	EM_downstream
CYR61	EM_downstream
CYSLTR1	EM_downstream
DAXX	EM_downstream
DBP	Mixed_downstream
DCD	UC_downstream
DDAH1	EM_downstream
DDB2	UC_downstream
DDIT3	Mixed_downstream
DDIT4	EM_downstream
DDX17	MM_downstream
DDX54	None
DEFA1B	UC_downstream
DEFA1	UC_downstream
DEK	EM_downstream
DHCR24	UC_downstream
DHFR	EM_downstream
DICER1	EM_downstream
DKK1	EM_downstream
DLC1	UC_downstream
DNAJB1	EM_downstream
DNMT1	UC_downstream
DNMT3A	UC_downstream
DNMT3B	EM_downstream
DPP3	UC_downstream
DRD2	UC_downstream
DUSP1	UC_downstream
DUSP6	UC_downstream
DVL3	UC_downstream
E2F2	Mixed_downstream
E2F3	Mixed_downstream
E2F4	UC_downstream
E2F5	UC_downstream
E2F6	UC_downstream
E2F7	EM_downstream
E2F8	EM_downstream
E4F1	Mixed_downstream
EBF1	EM_downstream
EBF2	Mixed_downstream
EBI3	None
EDN1	EM_downstream
EDNRA	Mixed_downstream
EDNRB	UC_downstream
EGF	EM_downstream
EGFR	None
EGLN1	Mixed_downstream
EGR1	Mixed_downstream
EGR2	Mixed_downstream
EGR3	Mixed_downstream
EGR4	Mixed_downstream
EHMT1	EM_downstream
EHMT2	EM_downstream
EIF2A	EM_downstream
EIF2AK3	Mixed_downstream
EIF2S1	EM_downstream
ELANE	EM_downstream
ELAVL1	Mixed_downstream
ELF1	Mixed_downstream
ELF2	Mixed_downstream
ELL	UC_downstream
EN1	EM_downstream
ENO1	UC_downstream
ENTPD1	EM_downstream
EOMES	EM_downstream
EP300	None
EP400	EM_downstream
EPAS1	Mixed_downstream
EPO	EM_downstream
EPOR	EM_downstream
ERBB2	UC_downstream
ERBB4	None
ERCC2	UC_downstream
ERCC3	UC_downstream
ERCC4	UC_downstream
ERCC6	UC_downstream
EREG	UC_downstream
ERF	EM_downstream
ERN1	EM_downstream
ESR1	Mixed_downstream
ESR2	Mixed_downstream
ESRRA	Mixed_downstream
ESRRB	MM_downstream
ESRRG	None
ETFA	EM_downstream
ETS1	Mixed_downstream
ETS2	Mixed_downstream
ETV4	Mixed_downstream
ETV5	EM_downstream
ETV7	Mixed_downstream
EZH2	Mixed_downstream
EZR	Mixed_downstream
F2	EM_downstream
F2RL1	EM_downstream
F3	EM_downstream
F5	MM_downstream
F7	EM_downstream
FABP4	UC_downstream
FADD	Mixed_downstream
FAM120B	None
FANCD2	UC_downstream
FANCI	UC_downstream
FASLG	EM_downstream
FASN	None
FBXO6	Mixed_downstream
FBXW7	UC_downstream
FCER2	EM_downstream
FGB	EM_downstream
FGF10	Mixed_downstream
FGF19	EM_downstream
FGF2	EM_downstream
FGF7	None
FGF8	EM_downstream
FGF9	EM_downstream
FGFR1	EM_downstream
FGFR2	EM_downstream
FHL2	Mixed_downstream
FKBP4	EM_downstream
FLT1	Mixed_downstream
FLT3	UC_downstream
FLT3LG	EM_downstream
FN1	EM_downstream
FOS	None
FOSB	Mixed_downstream
FOSL1	EM_downstream
FOSL2	EM_downstream
FOXA1	Mixed_downstream
FOXA3	None
FOXC1	EM_downstream
FOXD3	EM_downstream
FOXF1	EM_downstream
FOXF2	Mixed_downstream
FOXG1	EM_downstream
FOXH1	Mixed_downstream
FOXI1	Mixed_downstream
FOXJ1	Mixed_downstream
FOXJ2	Mixed_downstream
FOXL1	Mixed_downstream
FOXL2	UC_downstream
FOXM1	Mixed_downstream
FOXN1	Mixed_downstream
FOXO1	Mixed_downstream
FOXO3	Mixed_downstream
FOXP1	MM_downstream
FOXP3	EM_downstream
FOXQ1	Mixed_downstream
FSCN1	EM_downstream
FSHB	EM_downstream
FST	EM_downstream
FTL	EM_downstream
FXN	UC_downstream
FYN	EM_downstream
FZR1	EM_downstream
G3BP1	EM_downstream
GAB1	EM_downstream
GAB2	EM_downstream
GABPA	Mixed_downstream
GABPB1	Mixed_downstream
GABPB2	Mixed_downstream
GADD45A	EM_downstream
GAST	EM_downstream
GATA1	Mixed_downstream
GATA2	Mixed_downstream
GATA3	EM_downstream
GATA4	EM_downstream
GATA6	EM_downstream
GBA	Mixed_downstream
GCM1	Mixed_downstream
GDNF	EM_downstream
GEMIN4	None
GFI1	EM_downstream
GHRL	Mixed_downstream
GJB1	UC_downstream
GLI1	EM_downstream
GLI2	EM_downstream
GLI3	EM_downstream
GLO1	None
GLRX	MM_downstream
GNAI1	UC_downstream
GNAI2	UC_downstream
GNAI3	UC_downstream
GNAO1	UC_downstream
GNAQ	UC_downstream
GNAS	EM_downstream
GNAZ	UC_downstream
GNMT	UC_downstream
GPR39	UC_downstream
GPX1	EM_downstream
GPX4	Mixed_downstream
GRB2	EM_downstream
GREM1	EM_downstream
GSK3A	MM_downstream
GSK3B	Mixed_downstream
GSN	EM_downstream
GSTA1	EM_downstream
GSTM1	EM_downstream
GSTO1	EM_downstream
GSTP1	EM_downstream
GSTT1	EM_downstream
GTF2A2	Mixed_downstream
GTF2F1	UC_downstream
GTF2F2	UC_downstream
GTF2H1	UC_downstream
GTF2H2	UC_downstream
GTF2H3	UC_downstream
GTF2H4	UC_downstream
GTF3A	Mixed_downstream
GUSB	Mixed_downstream
H2AFB1	EM_downstream
H2AFX	EM_downstream
H2AFZ	EM_downstream
H3F3A	EM_downstream
H3F3B	EM_downstream
HAMP	UC_downstream
HAND1	Mixed_downstream
HBA1	EM_downstream
HBA2	EM_downstream
HBEGF	Mixed_downstream
HBP1	EM_downstream
HCAR2	Mixed_downstream
HCFC1	Mixed_downstream
HDAC1	EM_downstream
HDAC2	None
HDAC3	EM_downstream
HDAC4	Mixed_downstream
HDAC5	UC_downstream
HDAC6	None
HDAC7	Mixed_downstream
HDAC8	EM_downstream
HES1	EM_downstream
HES6	EM_downstream
HEY1	EM_downstream
HEY2	EM_downstream
HEYL	EM_downstream
HGF	Mixed_downstream
HHIP	Mixed_downstream
HIF1A	Mixed_downstream
HIF3A	EM_downstream
HIP1	EM_downstream
HIPK1	EM_downstream
HIPK2	EM_downstream
HIST1H2AB	EM_downstream
HIST1H2AC	EM_downstream
HIST1H2AD	EM_downstream
HIST1H2AE	EM_downstream
HIST1H2AJ	EM_downstream
HIST1H2BA	EM_downstream
HIST1H2BB	EM_downstream
HIST1H2BC	EM_downstream
HIST1H2BD	EM_downstream
HIST1H2BE	EM_downstream
HIST1H2BF	EM_downstream
HIST1H2BG	EM_downstream
HIST1H2BH	EM_downstream
HIST1H2BI	EM_downstream
HIST1H2BJ	EM_downstream
HIST1H2BK	EM_downstream
HIST1H2BL	EM_downstream
HIST1H2BM	EM_downstream
HIST1H2BN	EM_downstream
HIST1H2BO	EM_downstream
HIST1H3A	EM_downstream
HIST1H3B	EM_downstream
HIST1H3D	EM_downstream
HIST1H3E	EM_downstream
HIST1H3H	EM_downstream
HIST1H3I	EM_downstream
HIST1H3J	EM_downstream
HIST1H4A	EM_downstream
HIST1H4B	EM_downstream
HIST1H4C	EM_downstream
HIST1H4D	EM_downstream
HIST1H4E	EM_downstream
HIST1H4F	EM_downstream
HIST1H4H	EM_downstream
HIST1H4I	EM_downstream
HIST1H4J	EM_downstream
HIST1H4K	EM_downstream
HIST1H4L	EM_downstream
HIST2H2AA3	EM_downstream
HIST2H2AA4	EM_downstream
HIST2H2BE	EM_downstream
HIST2H3A	EM_downstream
HIST2H3C	EM_downstream
HIST2H3D	EM_downstream
HIST2H4A	EM_downstream
HIST2H4B	EM_downstream
HIST3H2BB	EM_downstream
HIST4H4	EM_downstream
HLA-A	EM_downstream
HLA-DRA	EM_downstream
HLA-DRB1	EM_downstream
HLF	Mixed_downstream
HMGA1	Mixed_downstream
HMGA2	EM_downstream
HMGCR	EM_downstream
HMOX1	Mixed_downstream
HNF1A	Mixed_downstream
HNF1B	EM_downstream
HNRNPA1	EM_downstream
HNRNPD	EM_downstream
HOMER3	EM_downstream
HOXA3	EM_downstream
HOXA4	Mixed_downstream
HOXA5	EM_downstream
HOXA9	Mixed_downstream
HOXB13	EM_downstream
HOXC4	EM_downstream
HPX	EM_downstream
HR	Mixed_downstream
HRH1	Mixed_downstream
HRH2	EM_downstream
HRH4	EM_downstream
HSD11B1	Mixed_downstream
HSD11B2	EM_downstream
HSF2	Mixed_downstream
HSPA1A	EM_downstream
HSPA1B	EM_downstream
HSPA5	EM_downstream
HSPA9	MM_downstream
HTR2A	EM_downstream
IAPP	Mixed_downstream
ICAM1	EM_downstream
IDH3A	UC_downstream
IFNA10	EM_downstream
IFNA13	None
IFNA14	EM_downstream
IFNA16	EM_downstream
IFNA17	EM_downstream
IFNA1	None
IFNA21	EM_downstream
IFNA2	None
IFNA4	EM_downstream
IFNA6	EM_downstream
IFNA7	EM_downstream
IFNA8	EM_downstream
IFNAR1	EM_downstream
IFNAR2	Mixed_downstream
IFNB1	Mixed_downstream
IFNG	None
IGF1	Mixed_downstream
IGF1R	Mixed_downstream
IGF2BP1	EM_downstream
IGFBP5	UC_downstream
IHH	Mixed_downstream
IKBKB	EM_downstream
IL10	Mixed_downstream
IL11	EM_downstream
IL12A	EM_downstream
IL12B	EM_downstream
IL12RB2	EM_downstream
IL13	None
IL15	UC_downstream
IL17A	EM_downstream
IL18	None
IL18R1	None
IL18RAP	None
IL1A	None
IL1B	Mixed_downstream
IL1RN	EM_downstream
IL23A	EM_downstream
IL23R	EM_downstream
IL24	EM_downstream
IL27	None
IL27RA	None
IL2	None
IL2RA	EM_downstream
IL3	None
IL4	None
IL4R	EM_downstream
IL5	EM_downstream
IL6	EM_downstream
IL6R	EM_downstream
IL6ST	None
ILK	Mixed_downstream
ING4	EM_downstream
INHBA	EM_downstream
INSR	EM_downstream
IRF1	Mixed_downstream
IRF2	None
IRF3	None
IRF4	None
IRF7	Mixed_downstream
IRF8	Mixed_downstream
ISL1	EM_downstream
ITGA4	EM_downstream
ITGAL	EM_downstream
ITGAV	Mixed_downstream
ITGB1	UC_downstream
ITGB2	EM_downstream
ITPKA	UC_downstream
JAG1	None
JAK1	EM_downstream
JAK2	EM_downstream
JDP2	Mixed_downstream
JMY	EM_downstream
JUN	Mixed_downstream
JUNB	None
JUND	None
KAT2A	EM_downstream
KAT2B	Mixed_downstream
KAT5	Mixed_downstream
KAT7	EM_downstream
KCNMA1	EM_downstream
KCNMB1	EM_downstream
KDM1A	Mixed_downstream
KDM3A	None
KDM4B	EM_downstream
KDM4C	None
KDM5B	Mixed_downstream
KDR	EM_downstream
KEAP1	Mixed_downstream
KHSRP	Mixed_downstream
KIT	EM_downstream
KL	EM_downstream
KLF12	Mixed_downstream
KLF2	Mixed_downstream
KLF5	EM_downstream
KLF8	EM_downstream
KLK2	EM_downstream
KLK3	MM_downstream
KMT2B	EM_downstream
KMT2C	Mixed_downstream
KMT2D	Mixed_downstream
KMT2E	EM_downstream
KNG1	UC_downstream
KRAS	Mixed_downstream
KRT18	UC_downstream
KRT8	UC_downstream
LAT	UC_downstream
LATS2	EM_downstream
LCK	Mixed_downstream
LCN2	EM_downstream
LDB1	UC_downstream
LDHA	EM_downstream
LDLR	EM_downstream
LEF1	Mixed_downstream
LEP	EM_downstream
LEPR	EM_downstream
LGALS1	EM_downstream
LHX3	Mixed_downstream
LIF	EM_downstream
LIN37	UC_downstream
LMNA	UC_downstream
LMO1	UC_downstream
LMO2	Mixed_downstream
LPA	EM_downstream
LPIN1	EM_downstream
LPL	None
LRIG1	EM_downstream
LRRK2	Mixed_downstream
LTA	EM_downstream
LY96	EM_downstream
MACROD1	UC_downstream
MAF	Mixed_downstream
MAFA	EM_downstream
MAFG	Mixed_downstream
MAK	EM_downstream
MAML1	EM_downstream
MAMLD1	EM_downstream
MAP2K1	Mixed_downstream
MAP2K2	UC_downstream
MAP2K3	EM_downstream
MAP2K4	Mixed_downstream
MAP2K5	Mixed_downstream
MAP2K6	None
MAP3K1	None
MAP3K5	Mixed_downstream
MAP4K4	EM_downstream
MAPK11	Mixed_downstream
MAPK12	Mixed_downstream
MAPK14	Mixed_downstream
MAPK1	Mixed_downstream
MAPK3	Mixed_downstream
MAPK7	Mixed_downstream
MAPK8	EM_downstream
MAPK9	None
MAPKAPK2	EM_downstream
MAPKAPK3	EM_downstream
MAT2B	Mixed_downstream
MAX	Mixed_downstream
MAZ	Mixed_downstream
MDC1	UC_downstream
MDM2	EM_downstream
MDM4	Mixed_downstream
MECOM	Mixed_downstream
MED10	None
MED11	None
MED12	EM_downstream
MED13	None
MED13L	None
MED14	None
MED15	None
MED16	None
MED17	None
MED19	None
MED1	Mixed_downstream
MED20	None
MED21	None
MED22	None
MED23	None
MED24	None
MED26	None
MED27	None
MED28	None
MED29	None
MED30	None
MED31	None
MED4	None
MED6	None
MED7	None
MED8	None
MED9	None
MEF2C	Mixed_downstream
MEF2D	EM_downstream
MEIS1	Mixed_downstream
MET	EM_downstream
MFGE8	Mixed_downstream
MGAT5	Mixed_downstream
MGMT	UC_downstream
MIF	Mixed_downstream
MITF	EM_downstream
MKL1	Mixed_downstream
MLH1	UC_downstream
MLST8	Mixed_downstream
MLX	UC_downstream
MLXIPL	UC_downstream
MME	EM_downstream
MMP14	UC_downstream
MMP9	EM_downstream
MNAT1	UC_downstream
MOV10	None
MPG	MM_downstream
MPO	None
MSH3	EM_downstream
MSMO1	UC_downstream
MSX1	Mixed_downstream
MT1A	EM_downstream
MT2A	Mixed_downstream
MTA1	EM_downstream
MTF1	Mixed_downstream
MTNR1B	EM_downstream
MTOR	Mixed_downstream
MXD1	UC_downstream
MYB	Mixed_downstream
MYBL2	UC_downstream
MYC	Mixed_downstream
MYCBP	UC_downstream
MYCN	Mixed_downstream
MYD88	None
MYOCD	Mixed_downstream
MYOD1	Mixed_downstream
MYOG	Mixed_downstream
NANOG	EM_downstream
NCF1	UC_downstream
NCOA1	Mixed_downstream
NCOA2	Mixed_downstream
NCOA3	Mixed_downstream
NCOA4	Mixed_downstream
NCOA6	Mixed_downstream
NCOA7	MM_downstream
NCOR1	Mixed_downstream
NCOR2	UC_downstream
NDFIP1	Mixed_downstream
NDRG1	None
NDRG2	EM_downstream
NELFA	UC_downstream
NELFB	UC_downstream
NELFCD	UC_downstream
NELFE	UC_downstream
NEUROD1	UC_downstream
NEUROG3	EM_downstream
NF1	Mixed_downstream
NFAT5	EM_downstream
NFATC1	None
NFATC2	None
NFATC3	None
NFATC4	UC_downstream
NFE2	Mixed_downstream
NFE2L1	Mixed_downstream
NFE2L2	Mixed_downstream
NFIB	None
NFKB1	EM_downstream
NFKBIA	EM_downstream
NFKBIB	EM_downstream
NFYA	UC_downstream
NFYB	UC_downstream
NGF	Mixed_downstream
NGFR	EM_downstream
NHLH1	Mixed_downstream
NKX2-1	Mixed_downstream
NKX2-5	Mixed_downstream
NLRC5	UC_downstream
NLRP3	EM_downstream
NMNAT1	EM_downstream
NOC2L	EM_downstream
NOD2	Mixed_downstream
NOG	Mixed_downstream
NOS3	EM_downstream
NOTCH1	EM_downstream
NOTCH2	EM_downstream
NOX4	EM_downstream
NOXO1	UC_downstream
NPAS2	Mixed_downstream
NPC1	UC_downstream
NPM1	Mixed_downstream
NQO1	None
NQO2	Mixed_downstream
NR0B1	UC_downstream
NR0B2	Mixed_downstream
NR1D1	EM_downstream
NR1H2	EM_downstream
NR1H4	Mixed_downstream
NR1I2	Mixed_downstream
NR1I3	Mixed_downstream
NR2C1	EM_downstream
NR2C2	EM_downstream
NR2F1	Mixed_downstream
NR3C1	Mixed_downstream
NR3C2	Mixed_downstream
NR4A1	EM_downstream
NR4A2	EM_downstream
NR4A3	EM_downstream
NR5A1	EM_downstream
NR5A2	EM_downstream
NR6A1	Mixed_downstream
NRAS	Mixed_downstream
NRF1	Mixed_downstream
NRG1	Mixed_downstream
NRIP1	EM_downstream
NTF3	EM_downstream
NTRK2	EM_downstream
NUDT1	UC_downstream
NUPR1	EM_downstream
ODC1	EM_downstream
OGG1	UC_downstream
OGT	EM_downstream
ONECUT1	EM_downstream
OR5I1	Mixed_downstream
ORMDL3	EM_downstream
OSM	EM_downstream
P2RX4	UC_downstream
P2RX7	UC_downstream
P2RY11	EM_downstream
P2RY6	UC_downstream
PARG	UC_downstream
PARP14	EM_downstream
PARP1	None
PATZ1	EM_downstream
PAWR	EM_downstream
PAX2	Mixed_downstream
PAX3	Mixed_downstream
PAX4	Mixed_downstream
PAX5	Mixed_downstream
PAX6	Mixed_downstream
PAX8	Mixed_downstream
PBX1	Mixed_downstream
PCBP1	Mixed_downstream
PCNA	MM_downstream
PDCD4	EM_downstream
PDE4A	Mixed_downstream
PDGFA	Mixed_downstream
PDGFB	Mixed_downstream
PDK4	EM_downstream
PDX1	EM_downstream
PELP1	EM_downstream
PER1	EM_downstream
PER2	EM_downstream
PEX19	MM_downstream
PGR	Mixed_downstream
PHB2	EM_downstream
PHB	EM_downstream
PIAS1	EM_downstream
PIAS3	EM_downstream
PIAS4	EM_downstream
PIK3CA	Mixed_downstream
PIK3R1	EM_downstream
PIN1	EM_downstream
PINK1	Mixed_downstream
PITX2	Mixed_downstream
PKN1	None
PKN3	EM_downstream
PLAUR	EM_downstream
PLCG1	EM_downstream
PLD1	Mixed_downstream
PLD2	None
PLK1	EM_downstream
PLK3	EM_downstream
PLXND1	EM_downstream
PMAIP1	EM_downstream
PML	EM_downstream
PNCK	UC_downstream
POLH	UC_downstream
POLR2A	Mixed_downstream
POLR2B	Mixed_downstream
POLR2C	Mixed_downstream
POLR2D	Mixed_downstream
POLR2E	Mixed_downstream
POLR2G	Mixed_downstream
POLR2H	Mixed_downstream
POLR2I	Mixed_downstream
POLR2J	Mixed_downstream
POLR2K	Mixed_downstream
POLR2L	Mixed_downstream
POMC	EM_downstream
PON1	Mixed_downstream
POR	UC_downstream
POSTN	EM_downstream
POU1F1	Mixed_downstream
POU2F1	Mixed_downstream
POU3F1	Mixed_downstream
POU3F2	Mixed_downstream
POU4F1	EM_downstream
POU4F2	EM_downstream
POU5F1	EM_downstream
POU6F1	EM_downstream
PPARA	Mixed_downstream
PPARD	Mixed_downstream
PPARG	Mixed_downstream
PPARGC1A	Mixed_downstream
PPARGC1B	UC_downstream
PPIA	EM_downstream
PPP1R13B	Mixed_downstream
PPP1R15A	UC_downstream
PPP2CA	Mixed_downstream
PPP2R1A	EM_downstream
PPP2R2A	UC_downstream
PPP2R5C	UC_downstream
PPP2R5E	UC_downstream
PPRC1	Mixed_downstream
PRAM1	EM_downstream
PRDM1	EM_downstream
PRDX1	EM_downstream
PRDX2	EM_downstream
PRDX4	Mixed_downstream
PRKAA1	EM_downstream
PRKAA2	Mixed_downstream
PRKACA	Mixed_downstream
PRKACB	Mixed_downstream
PRKCA	None
PRKCB	None
PRKCD	None
PRKCE	None
PRKCG	None
PRKCH	None
PRKCQ	EM_downstream
PRKCZ	None
PRKDC	EM_downstream
PRKG1	UC_downstream
PRLR	MM_downstream
PRMT5	EM_downstream
PRMT6	EM_downstream
PRODH	UC_downstream
PROX1	EM_downstream
PRRX2	EM_downstream
PSEN1	EM_downstream
PSEN2	Mixed_downstream
PTCH1	EM_downstream
PTEN	Mixed_downstream
PTF1A	Mixed_downstream
PTGDR	Mixed_downstream
PTGDS	UC_downstream
PTGER1	EM_downstream
PTGER2	EM_downstream
PTGES2	EM_downstream
PTGES	EM_downstream
PTGR1	EM_downstream
PTGS1	Mixed_downstream
PTGS2	Mixed_downstream
PTH	Mixed_downstream
PTHLH	None
PTK2B	EM_downstream
PTMA	EM_downstream
PTPN1	MM_downstream
PTPN2	UC_downstream
PUM2	EM_downstream
RAC1	None
RAD23B	Mixed_downstream
RAD51	Mixed_downstream
RAD51D	UC_downstream
RAF1	Mixed_downstream
RAG1	EM_downstream
RAG2	EM_downstream
RALA	EM_downstream
RANBP9	EM_downstream
RAP2A	EM_downstream
RARB	EM_downstream
RARG	EM_downstream
RASSF1	EM_downstream
RASSF5	EM_downstream
RB1	Mixed_downstream
RB1CC1	EM_downstream
RBBP4	UC_downstream
RBBP5	EM_downstream
RBBP7	UC_downstream
RBBP8	Mixed_downstream
RBL1	UC_downstream
RBL2	UC_downstream
RBM4	EM_downstream
RBP2	UC_downstream
RBPJ	EM_downstream
RCOR1	Mixed_downstream
RECK	EM_downstream
RELA	None
REL	Mixed_downstream
RELB	Mixed_downstream
REPIN1	Mixed_downstream
REST	EM_downstream
RFX1	Mixed_downstream
RHEB	EM_downstream
RHOA	Mixed_downstream
RHOB	EM_downstream
RNASEL	None
RNF128	MM_downstream
RNF187	EM_downstream
RNF34	Mixed_downstream
RORA	Mixed_downstream
RORC	EM_downstream
RPL11	UC_downstream
RPS6KA3	EM_downstream
RPS6KB1	EM_downstream
RPTOR	Mixed_downstream
RREB1	Mixed_downstream
RUNX1	Mixed_downstream
RUNX2	Mixed_downstream
RUNX3	EM_downstream
RUVBL1	Mixed_downstream
RUVBL2	Mixed_downstream
RXRA	Mixed_downstream
RXRB	Mixed_downstream
RXRG	EM_downstream
RYBP	UC_downstream
RYR1	EM_downstream
S100A11	UC_downstream
S100A4	EM_downstream
S100B	None
S1PR3	UC_downstream
SALL4	EM_downstream
SAP18	UC_downstream
SAP30	UC_downstream
SCAI	EM_downstream
SDC2	EM_downstream
SEMA4A	EM_downstream
SENP1	EM_downstream
SERPINB5	EM_downstream
SESN2	EM_downstream
SETD1A	EM_downstream
SETD1B	EM_downstream
SETD7	EM_downstream
SF1	Mixed_downstream
SFRP2	None
SFTPA2	EM_downstream
SGK1	Mixed_downstream
SGK2	Mixed_downstream
SHBG	EM_downstream
SHC1	EM_downstream
SHH	EM_downstream
SIK1	EM_downstream
SIN3A	Mixed_downstream
SIN3B	Mixed_downstream
SIRT1	EM_downstream
SIRT3	None
SIRT4	EM_downstream
SIRT5	EM_downstream
SIRT7	Mixed_downstream
SKI	UC_downstream
SLC20A1	UC_downstream
SLC22A2	EM_downstream
SLC31A1	EM_downstream
SLC38A2	EM_downstream
SLC39A2	UC_downstream
SLC39A6	EM_downstream
SLC39A8	EM_downstream
SLC3A2	EM_downstream
SLC46A1	EM_downstream
SLC6A3	EM_downstream
SLURP1	EM_downstream
SMAD1	Mixed_downstream
SMAD2	None
SMAD3	Mixed_downstream
SMAD4	Mixed_downstream
SMAD7	EM_downstream
SMAD9	None
SMARCA2	EM_downstream
SMARCA4	Mixed_downstream
SMARCB1	EM_downstream
SMARCC1	Mixed_downstream
SMARCC2	UC_downstream
SMARCD1	UC_downstream
SMARCD3	Mixed_downstream
SMARCE1	EM_downstream
SMO	EM_downstream
SMPD1	EM_downstream
SNAI1	EM_downstream
SNCA	None
SND1	EM_downstream
SNW1	EM_downstream
SOD1	Mixed_downstream
SOD2	None
SOS1	EM_downstream
SOX2	EM_downstream
SOX30	EM_downstream
SOX9	Mixed_downstream
SP1	Mixed_downstream
SP3	Mixed_downstream
SP4	EM_downstream
SPARC	MM_downstream
SPDEF	EM_downstream
SPDL1	UC_downstream
SPEN	EM_downstream
SPHK1	EM_downstream
SPHK2	EM_downstream
SPI1	Mixed_downstream
SPP1	EM_downstream
SPZ1	Mixed_downstream
SQSTM1	EM_downstream
SRC	None
SRD5A1	UC_downstream
SREBF1	Mixed_downstream
SREBF2	UC_downstream
SRF	Mixed_downstream
SRSF2	EM_downstream
SRSF3	UC_downstream
SRY	EM_downstream
SSRP1	UC_downstream
SSTR2	EM_downstream
SSTR5	EM_downstream
STAM2	UC_downstream
STAM	UC_downstream
STAT1	Mixed_downstream
STAT2	Mixed_downstream
STAT3	EM_downstream
STAT4	Mixed_downstream
STAT5A	Mixed_downstream
STAT5B	Mixed_downstream
STAT6	Mixed_downstream
STK11	Mixed_downstream
STK17A	EM_downstream
SULT2A1	UC_downstream
SUMO1	EM_downstream
SUPT16H	UC_downstream
SUPT3H	Mixed_downstream
SUPT4H1	UC_downstream
SUPT5H	UC_downstream
SUPT7L	Mixed_downstream
SVIL	EM_downstream
TAB2	None
TAC1	EM_downstream
TADA2B	EM_downstream
TAF10	Mixed_downstream
TAF12	Mixed_downstream
TAL1	UC_downstream
TBK1	EM_downstream
TBL1X	Mixed_downstream
TBL1XR1	Mixed_downstream
TBP	None
TBX21	Mixed_downstream
TBX5	EM_downstream
TCF12	Mixed_downstream
TCF3	Mixed_downstream
TCF4	EM_downstream
TCF7	EM_downstream
TCF7L1	Mixed_downstream
TCF7L2	EM_downstream
TDP1	UC_downstream
TEAD1	EM_downstream
TEAD2	EM_downstream
TEAD4	EM_downstream
TEK	EM_downstream
TERT	Mixed_downstream
TES	Mixed_downstream
TFAM	UC_downstream
TFAP2A	Mixed_downstream
TFAP2B	EM_downstream
TFAP2C	Mixed_downstream
TFAP4	Mixed_downstream
TFCP2	Mixed_downstream
TFDP1	Mixed_downstream
TFDP2	Mixed_downstream
TFEB	Mixed_downstream
TGFA	None
TGFB1	EM_downstream
TGFB1I1	Mixed_downstream
TGFB2	Mixed_downstream
TGFB3	Mixed_downstream
TGFBI	None
TGIF1	Mixed_downstream
TGIF2	EM_downstream
TGS1	Mixed_downstream
THPO	EM_downstream
THRAP3	None
THRA	UC_downstream
THRB	UC_downstream
TIMP2	UC_downstream
TIPARP	Mixed_downstream
TLE1	EM_downstream
TLR2	Mixed_downstream
TLR3	MM_downstream
TLR4	EM_downstream
TLR9	UC_downstream
TLX2	Mixed_downstream
TMF1	EM_downstream
TNF	Mixed_downstream
TNFAIP3	EM_downstream
TNFAIP6	EM_downstream
TNFRSF10A	None
TNFRSF10B	None
TNFRSF10C	None
TNFRSF10D	None
TNFRSF1A	UC_downstream
TNFSF11	EM_downstream
TNIK	Mixed_downstream
TNRC6A	None
TNRC6B	None
TNRC6C	None
TOP2B	EM_downstream
TOPBP1	MM_downstream
TP53	Mixed_downstream
TP53BP2	Mixed_downstream
TP63	Mixed_downstream
TP73	Mixed_downstream
TRAF4	Mixed_downstream
TRAP1	Mixed_downstream
TRH	EM_downstream
TRIB3	EM_downstream
TRIM24	EM_downstream
TRIM28	Mixed_downstream
TRIM33	Mixed_downstream
TRIM59	EM_downstream
TRIM7	MM_downstream
TRIP6	EM_downstream
TRPM7	UC_downstream
TRPV1	EM_downstream
TRPV4	EM_downstream
TRPV6	EM_downstream
TRRAP	Mixed_downstream
TSC22D3	EM_downstream
TSHB	EM_downstream
TSLP	EM_downstream
TTF1	MM_downstream
TWIST1	EM_downstream
TXLNG	EM_downstream
TXN	None
TXNIP	EM_downstream
TYK2	EM_downstream
TYMP	None
TYMS	EM_downstream
TYR	UC_downstream
UBA3	EM_downstream
UBE2C	EM_downstream
UBE2D1	EM_downstream
UBE2E1	EM_downstream
UBE3A	Mixed_downstream
UBP1	Mixed_downstream
UCN	EM_downstream
UCP1	MM_downstream
UGT1A3	EM_downstream
USF2	EM_downstream
UXT	None
VAV3	EM_downstream
VDR	Mixed_downstream
VEGFA	EM_downstream
VEGFC	Mixed_downstream
VHL	Mixed_downstream
VIP	Mixed_downstream
VSX1	Mixed_downstream
WDR5	EM_downstream
WNT3A	Mixed_downstream
WNT5A	UC_downstream
WNT7A	EM_downstream
WRN	Mixed_downstream
WT1	UC_downstream
WWTR1	EM_downstream
XBP1	Mixed_downstream
XPA	EM_downstream
XRCC5	EM_downstream
XRCC6	EM_downstream
YAP1	Mixed_downstream
YBX1	EM_downstream
YY1	Mixed_downstream
ZAP70	UC_downstream
ZBTB14	Mixed_downstream
ZBTB17	EM_downstream
ZBTB18	EM_downstream
ZBTB33	EM_downstream
ZEB1	Mixed_downstream
ZFHX3	EM_downstream
ZFPM1	Mixed_downstream
ZHX2	EM_downstream
ZIC1	Mixed_downstream
ZIC2	Mixed_downstream
ZIC3	Mixed_downstream
ZMIZ2	EM_downstream
ZMYND8	Mixed_downstream
ZNF318	EM_downstream
ZNF366	UC_downstream
ZNF385A	None
ZNF423	None
ZNF461	EM_downstream
ZNF467	EM_downstream
ZNFX1	UC_downstream
